NO ./0.xpm
SO ./0.xpm
WE ./wall.xpm
EA ./wall.xpm


F 200,10,255
C 225,30,9

11      11111111111111111111111111
101      11000000000110000000000001
11      10110000011100000000000011
        1001000000000000000000001
111111111011000001110000000000001
100000000011000001 10111111111111 
11110111111111011110000010001
11110111111111011101010010001
11000000110101011100000010001
1000010100000001100000010001        11
10001010000000001101010010001       1N1
11000101110101011111011110111        11
11110111 1110101 101111010001
11111111 1111111 11111111111