NO ./0.xpm
SO ./0.xpm
WE ./wall.xpm
EA ./wall.xpm


F 220,1,1
C 225,30,9

        1111111111111111111111111
         1000000000111000000000001
         11111111111111111111111111
        100100000000000 0000000001111
111111111011000001110000000000001
100000000011000001110111111111111
11110111111111011100000010001
1111011111111111101010010001
111111111111111111111111111111
1S1
111111111111111111111111111111
11000000110101011100000010011     1
10000000000000001100000010001    101
10000000000000001101010010011     1
1100000111010101111101111000111
11110111 1110101 1011110100001                                                                                  1
 11111111 1111111 11111111111
1 1 1
