NO ./0.xpm
SO ./0.xpm
WE ./wall.xpm
EA ./wall.xpm


F 1,5,5
C 225,30,9

        1111111111111111111111111
        1000000000110000000000001
        1011000001110000000000001
        1001000000000000000000001
111111111011000001110000000000001
100000000011000001110111111111111
11110111111111011100000010001
11110111111111011101010010001
11000000110101011100000010001
1000010N000000001100000010001        1
10001010000000001101010010001       1 1
1100010111010101111101111000111      1
11110111 1110101 101111010001
11111111 1111111 111111111111
