NO ../map_test/colorstone.xpm
SO ../map_test/colorstone.xpm
WE ../map_test/colorstone.xpm
EA ../map_test/colorstone.xpm


F 220,100,0
C 225,30,0


1111111111111111111111111111111
1000000000000000000000000000001
1000000000110000000010000000001
1000000000110000000001000000001
1011000000000000000000000000001
10010000N0000000000000000000001
1111111111111111111111111111111