NO ../map_test/0.xpm
SO ../map_test/0.xpm
WE ../map_test/wall.xpm
EA ../map_test/wall.xpm


F 220,100,0
C 225,30,0


1111111111111111111111111111111
1000000000000000000000000000001
1000000000110000000000000000001
1000N00000110000000000000000001
1000000000000000000000000000001
1011000000000000000000000000001
1001000000000000000000000000001
1111111111111111111111111111111