NO maps/xpm_files/1.xpm
SO maps/xpm_files/1.xpm
WE maps/xpm_files/brick_windows.xpm
EA maps/xpm_files/brick_windows.xpm


F 57,57,71
C 0,0,55


1111111111111111111111111111111
1000000000000000000000000000001
1000000000110000000010000000001
1000000000110000000001000000001
1011000000000000000000000000001
10010000W0000000000000000000001
1111111111111111111111111111111