NO maps/xpm_files/eagle.xpm
SO maps/xpm_files/colorstone.xpm
WE maps/xpm_files/rock.xpm
EA maps/xpm_files/planks.xpm


F 57,57,71
C 231,240,245


1111111111111111111111111111111
1000000000000000000000000000001
1000000000110000000010000000001
1000000000110000000001000000001
1011000000000000000000000000001
10010000E0000000000000000000001
1111111111111111111111111111111